price,bedrooms,bathrooms,sqft_living,sqft_lot,floors,grade,area,town
221900,3,1,1180,5650,1,7,6830,Delhi
538000,3,2.25,2570,7242,2,7,9812,Delhi
180000,2,1,770,10000,1,6,10770,Delhi
604000,4,3,1960,5000,1,7,6960,Delhi
510000,3,2,1680,8080,1,8,9760,Hapur
1225000,4,4.5,5420,101930,1,11,107350,Hapur
257500,3,2.25,1715,6819,2,7,8534,Hapur
291850,3,1.5,1060,9711,1,7,10771,Hissar
229500,3,1,1780,7470,1,7,9250,Hissar
323000,3,2.5,1890,6560,2,7,8450,Hissar
